Aa, Aa, Aa, Aa, Mm, Mm, Mm, Aa, Aa, Aa, Aa, Mm, Mm, Mm, Aa, Aa, Aa, Aa, Aa, Aa
Aa, Aa, Gs, Gs, Mm^Xm, Mm^Xm, Mm^Xm, Aa, Aa, Aa, Aa, Mm^Xm, Mm^Xm, Mm^Xm, Aa, Aa, Aa, Aa, Aa, Aa
Aa, Gs, Gs, Gs, Gs, Mm^Xm, Mm^Xm, Aa, Aa, Aa, Aa, Mm^Xm, Mm^Xm, Gs, Gs, Gs, Gs, Aa, Aa, Aa
Aa, Gs, Gs, Gg, Gg, Gs, Gs, Aa, Aa, Aa, Aa, Gs, Gs, Gg, Gg, Gs, Gs, Aa, Aa, Aa
Aa, Gs, Gg, Gg, Ch, Ch, Gg, Gs, Aa, Aa, Aa, Gg, Ch, Ch, Gg, Gg, Gs, Aa, Aa, Aa
Aa, Aa, Gs, Gg, Ch, Ch, Gg, Gs, Aa, Aa, Aa, Gg, Ch, Ch, Gg, Gs, Gs, Aa, Aa, Aa
Aa, Aa, Gs, Gs, Gg, Gg, Gs, Gs, Aa, Aa, Aa, Gs, Gs, Gg, Gg, Gs, Gs, Aa, Aa, Aa
Aa, Aa, Aa, Gs, Gs, Gs, Gs, Gs, Gs, Gs, Gs, Gs, Gs, Gs, Gs, Gs, Aa, Aa, Aa, Aa
Aa, Aa, Aa, Aa, Gs, Gs, Gs, Gs, Gs, Gs, Gs, Gs, Gs, Gs, Gs, Aa, Aa, Aa, Aa, Aa
Aa, Aa, Aa, Aa, Aa, Gs, Gs, Gs, Gs, Gg, Gg, Gg, Gs, Gs, Aa, Aa, Aa, Aa, Aa, Aa
Aa, Aa, Aa, Aa, Aa, Aa, Gs, Gs, Gs, Gs, Gg, Gs, Gs, Aa, Aa, Aa, Aa, Aa, Aa, Aa
Aa, Aa, Aa, Aa, Aa, Aa, Aa, Gs, Gs, Gs, Gs, Gs, Aa, Aa, Aa, Aa, Aa, Aa, Aa, Aa
Aa, Aa, Aa, Aa, Aa, Aa, Aa, Aa, Gs, Gs, Gs, Aa, Aa, Aa, Aa, Aa, Aa, Aa, Aa, Aa
Aa, Aa, Aa, Aa, Aa, Aa, Aa, Aa, Aa, Gs, Aa, Aa, Aa, Aa, Aa, Aa, Aa, Aa, Aa, Aa
Aa, Aa, Aa, Aa, Aa, Aa, Aa, Aa, Aa, Aa, Aa, Aa, Aa, Aa, Aa, Aa, Aa, Aa, Aa, Aa
