Mm^Xm, Mm^Xm, Mm^Xm, Hh, Mm, Mm, Mm, Hh, Mm^Xm, Mm^Xm, Hh, Mm, Mm, Mm, Hh, Mm^Xm, Mm^Xm, Mm^Xm, Mm^Xm, Mm^Xm
Mm^Xm, Hh, Gs, Gs, Mm^Xm, Mm^Xm, Mm^Xm, Hh, Mm^Xm, Mm^Xm, Hh, Mm^Xm, Mm^Xm, Mm^Xm, Hh, Gs, Gs, Mm^Xm, Mm^Xm, Mm^Xm
Hh, Gs, Gs, Gs, Gs, Mm^Xm, Mm^Xm, Hh, Mm^Xm, Mm^Xm, Hh, Mm^Xm, Mm^Xm, Gs, Gs, Gs, Gs, Hh, Mm^Xm, Mm^Xm
Hh, Gs, Gs, Gg, Gg, Gs, Gs, Hh, Mm^Xm, Mm^Xm, Hh, Gs, Gs, Gg, Gg, Gs, Gs, Hh, Mm^Xm, Mm^Xm
Hh, Gs, Gg, Gg, Ch, Ch, Gg, Gs, Mm^Xm, Mm^Xm, Hh, Gg, Ch, Ch, Gg, Gg, Gs, Hh, Mm^Xm, Mm^Xm
Hh, Hh, Gs, Gg, Ch, Ch, Gg, Gs, Mm^Xm, Mm^Xm, Hh, Gg, Ch, Ch, Gg, Gs, Gs, Hh, Mm^Xm, Mm^Xm
Hh, Hh, Gs, Gs, Gg, Gg, Gs, Gs, Mm^Xm, Mm^Xm, Hh, Gs, Gs, Gg, Gg, Gs, Gs, Hh, Mm^Xm, Mm^Xm
Hh, Hh, Hh, Gs, Gs, Gs, Gs, Gs, Gs, Gs, Gs, Gs, Gs, Gs, Gs, Gs, Hh, Hh, Mm^Xm, Mm^Xm
Hh, Hh, Hh, Hh, Gs, Gs, Gs, Gs, Gs, Gs, Gs, Gs, Gs, Gs, Gs, Hh, Hh, Hh, Mm^Xm, Mm^Xm
Hh, Hh, Hh, Hh, Hh, Gs, Gs, Gs, Gs, Gg, Gg, Gg, Gs, Gs, Hh, Hh, Hh, Hh, Hh, Mm^Xm
Hh, Hh, Hh, Hh, Hh, Hh, Gs, Gs, Gs, Gs, Gg, Gs, Gs, Hh, Hh, Hh, Hh, Hh, Hh, Hh
Hh, Hh, Hh, Hh, Hh, Hh, Hh, Gs, Gs, Gs, Gs, Gs, Hh, Hh, Hh, Hh, Hh, Hh, Hh, Hh
Hh, Hh, Hh, Hh, Hh, Hh, Hh, Hh, Gs, Gs, Gs, Hh, Hh, Hh, Hh, Hh, Hh, Hh, Hh, Hh
Hh, Hh, Hh, Hh, Hh, Hh, Hh, Hh, Hh, Gs, Hh, Hh, Hh, Hh, Hh, Hh, Hh, Hh, Hh, Hh
Hh, Hh, Hh, Hh, Hh, Hh, Hh, Hh, Hh, Hh, Hh, Hh, Hh, Hh, Hh, Hh, Hh, Hh, Hh, Hh
