Aa, Aa, Aa, Aa, Aa, Aa, Aa, Aa, Aa, Aa, Aa, Aa, Aa, Aa, Aa, Aa, Aa, Aa, Aa, Aa
Aa, Aa, Gs, Gs, Gs, Gs, Aa, Aa, Aa, Aa, Aa, Aa, Aa, Aa, Gs, Gs, Gs, Aa, Aa, Aa
Aa, Gs, Gs, Gs, Gs, Gs, Gs, Aa, Aa, Aa, Aa, Aa, Aa, Gs, Gs, Gs, Gs, Gs, Aa, Aa
Aa, Gs, Gs, Gg, Gg, Gs, Gs, Gs, Aa, Aa, Aa, Aa, Gs, Gs, Gs, Gg, Gs, Gs, Aa, Aa
Aa, Gs, Gg, Gg, Gg, Gg, Gs, Gs, Aa, Aa, Aa, Gs, Gs, Gs, Gg, Gg, Gg, Gs, Aa, Aa
Aa, Aa, Gs, Gg, Gg, Gg, Gs, Gs, Aa, Aa, Gs, Gs, Gs, Gg, Gg, Gg, Gs, Gs, Aa, Aa
Aa, Aa, Gs, Gs, Gg, Gg, Gs, Gs, Aa, Gs, Gs, Gs, Gg, Gg, Gg, Gs, Gs, Aa, Aa, Aa
Aa, Aa, Aa, Gs, Gs, Gs, Gs, Gs, Gs, Gs, Gs, Gg, Gg, Gg, Gs, Gs, Aa, Aa, Aa, Aa
Aa, Aa, Aa, Aa, Gs, Gs, Gs, Gs, Gs, Gs, Gg, Gg, Gg, Gs, Gs, Aa, Aa, Aa, Aa, Aa
Aa, Aa, Aa, Aa, Aa, Gs, Gs, Gs, Gs, Gg, Gg, Gg, Gs, Gs, Aa, Aa, Aa, Aa, Aa, Aa
Aa, Aa, Aa, Aa, Aa, Aa, Gs, Gs, Gs, Gs, Gg, Gs, Gs, Aa, Aa, Aa, Aa, Aa, Aa, Aa
Aa, Aa, Aa, Aa, Aa, Aa, Aa, Gs, Gs, Gs, Gs, Gs, Aa, Aa, Aa, Aa, Aa, Aa, Aa, Aa
Aa, Aa, Aa, Aa, Aa, Aa, Aa, Aa, Gs, Gs, Gs, Aa, Aa, Aa, Aa, Aa, Aa, Aa, Aa, Aa
Aa, Aa, Aa, Aa, Aa, Aa, Aa, Aa, Aa, Gs, Aa, Aa, Aa, Aa, Aa, Aa, Aa, Aa, Aa, Aa
Aa, Aa, Aa, Aa, Aa, Aa, Aa, Aa, Aa, Aa, Aa, Aa, Aa, Aa, Aa, Aa, Aa, Aa, Aa, Aa
