Gs, Gs, Gs, Gs, Gs, Gs, Gs, Gs, Aa, Aa, Aa, Aa, Gs, Gs, Gs, Gs, Gs, Gs, Gs, Gs
Gs, Gs, Gg, Gg, Gs, Gs, Gs, Gs, Aa, Aa, Aa, Aa, Gs, Gs, Gs, Gs, Gg, Gg, Gs, Gs
Gs, Gg, Gg, Gg, Gg, Gs, Gs, Aa, Aa, Aa, Aa, Aa, Aa, Gs, Gs, Gg, Gg, Gg, Gg, Gs
Gs, Gg, Gg, Gg, Gg, Gs, Gs, Aa, Aa, Aa, Aa, Aa, Aa, Gs, Gs, Gg, Gg, Gg, Gg, Gs
Gs, Gs, Gg, Gg, Gs, Gs, Aa, Aa, Aa, Aa, Aa, Aa, Aa, Aa, Gs, Gs, Gg, Gg, Gs, Gs
Gs, Gs, Gs, Gs, Gs, Aa, Aa, Aa, Aa, Aa, Aa, Aa, Aa, Aa, Aa, Gs, Gs, Gs, Gs, Gs
Gs, Gs, Gs, Gs, Aa, Aa, Aa, Aa, Aa, Aa, Aa, Aa, Aa, Aa, Aa, Aa, Gs, Gs, Gs, Gs
Aa, Aa, Aa, Aa, Aa, Aa, Aa, Aa, Aa, Aa, Aa, Aa, Aa, Aa, Aa, Aa, Aa, Aa, Aa, Aa
Aa, Aa, Aa, Aa, Aa, Aa, Aa, Aa, Aa, Aa, Aa, Aa, Aa, Aa, Aa, Aa, Aa, Aa, Aa, Aa
Gs, Gs, Gs, Gs, Aa, Aa, Aa, Aa, Aa, Aa, Aa, Aa, Aa, Aa, Aa, Aa, Gs, Gs, Gs, Gs
Gs, Gs, Gs, Gs, Gs, Aa, Aa, Aa, Aa, Aa, Aa, Aa, Aa, Aa, Aa, Gs, Gs, Gs, Gs, Gs
Gs, Gs, Gg, Gg, Gs, Gs, Aa, Aa, Aa, Aa, Aa, Aa, Aa, Aa, Gs, Gs, Gg, Gg, Gs, Gs
Gs, Gg, Gg, Gg, Gg, Gs, Gs, Aa, Aa, Aa, Aa, Aa, Aa, Gs, Gs, Gg, Gg, Gg, Gg, Gs
Gs, Gg, Gg, Gg, Gg, Gs, Gs, Aa, Aa, Aa, Aa, Aa, Aa, Gs, Gs, Gg, Gg, Gg, Gg, Gs
Gs, Gs, Gg, Gg, Gs, Gs, Gs, Gs, Aa, Aa, Aa, Aa, Gs, Gs, Gs, Gs, Gg, Gg, Gs, Gs
