Aa, Ms, Ms, Ms, Ms, Ms, Ms, Ms, Ms, Ms, Ms, Aa, Ms, Ms, Ms, Ms, Ms, Ms, Ms, Ms, Ms, Ms, Ms, Ms, Ms, Ms, Ms, Aa, Ms, Ms, Ms, Ms, Ms, Ms, Ms
Aa, Ms, Ms, Ms, Aa, Ms, Aa, Ms, Aa, Ms, Aa, Ms, Ha, Ms, Ha, Ha, Aa, Ha, Ha, Ha, Ha, Ha, Ha, Ha, Aa, Aa, Aa, Aa, Aa, Ms, Ms, Ms, Ms, Ms, Ms
Aa, Ms, Ms, Aa, Ha, Ha, Ha, Ha, Ha, Ha, Ha, Ha, Ha, Aa, Ha, Ha, Ha, Ha, Ha, Ha, Aa, Ha, Ha, Ha, Aa, Aa, Aa, Ha, Ha, Ha, Aa, Aa, Aa, Ms, Ms
Aa, Ms, Ha, Ha, Ha, Ha, Aa, Ha, Aa, Ha, Aa, Ha, Aa, Ha, Aa, Ha, Aa, Aa, Aa, Aa, Aa, Aa, Aa, Aa, Aa, Aa, Aa, Aa, Aa, Aa, Aa, Aa, Aa, Ms, Ms
Aa, Ms, Ha, Ha, Ha, Aa, Aa, Aa, Aa, Aa, Aa, Aa, Aa, Aa, Aa, Aa, Aa, Aa, Aa, Aa, Aa, Aa, Aa, Aa, Aa, Aa, Aa, Aa, Aa, Aa, Aa, Aa, Ms, Ms, Ms
Aa, Ms, Ms, Ha, Ha, Aa, Aa, Aa, Aa, Aa, Aa, Aa, Aa, Aa, Aa, Aa, Aa, Aa, Aa, Aa, Aa, Aa, Aa^Fpa, Aa, Aa, Aa, Aa, Aa, Ha, Ha, Aa, Ms, Ms, Ms, Ms
Aa, Ms, Ms, Ha, Ha, Aa, Aa, Aa, Aa, Aa, Aa, Aa, Aa, Aa, Aa, Aa, Aa, Aa, Aa, Aa, Aa, Aa^Fpa, Aa^Fpa, Aa^Fpa, Aa^Fpa, Aa, Aa, Ha, Ha, Ha, Ms, Ms, Aa, Ms, Ms
Aa, Ms, Ms, Ha, Ha, Aa, Aa, Aa, Aa, Aa, Aa, Aa, Aa, Aa, Aa, Aa, Aa^Fpa, Aa, Aa, Aa, Aa, Aa^Fpa, Aa, Aa^Fpa, Aa^Fda, Aa^Fpa, Aa, Aa, Ha, Ha, Ha, Ms, Ms, Ms, Ms
Aa, Ms, Ms, Ha, Ha, Aa, Aa, Aa, Aa, Aa, Aa, Aa, Aa, Aa, Aa, Aa, Aa^Fpa, Aa, Aa, Aa, Aa^Fda, Aa^Fpa, Aa^Fpa, Aa^Fda, Aa^Fpa, Aa^Fpa, Aa, Aa, Ha, Ha, Ha, Ms, Ms, Aa, Ms
Aa, Ms, Ms, Ha, Ha, Aa, Aa, Aa, Aa, Aa, Aa, Aa, Aa, Aa, Aa, Aa, Aa^Fpa, Aa^Fpa, Aa, Aa, Aa, Aa^Fpa, Aa^Fpa, Aa^Fpa, Aa, Aa, Aa, Aa, Aa, Aa, Ha, Ms, Ms, Ms, Ms
Aa, Aa, Aa, Ha, Ha, Ha, Aa, Aa, Aa, Aa, Aa, Aa, Aa^Fpa, Aa^Fpa, Aa^Fda, Aa^Fpa, Aa^Fpa, Aa, Aa, Aa, Aa, Aa, Aa, Aa, Aa, Aa, Aa, Aa, Aa, Ha, Ha, Ha, Ms, Ms, Ms
Aa, Ms, Ms, Ha, Ha, Aa, Aa, Aa, Aa, Aa, Aa, Aa, Aa^Fda, Aa^Fpa, Aa, Aa^Fpa, Aa^Fpa, Aa^Fpa, Aa, Aa, Aa, Aa, Aa, Aa, Aa, Aa, Ha, Ha, Aa, Aa, Aa, Aa, Aa, Ms, Aa
Aa, Aa, Aa, Ha, Aa, Aa, Aa, Aa, Aa, Aa, Aa, Aa^Fpa, Aa^Fpa, Aa^Fpa, Aa^Fpa, Aa^Fpa, Aa, Aa^Fpa, Aa, Aa, Aa, Ha, Aa, Aa, Aa, Aa, Ha, Aa, Aa, Ha, Aa, Ha, Ms, Aa, Ha
Aa, Ms, Ms, Ha, Ha, Aa, Aa, Aa, Aa, Aa, Aa, Aa, Aa, Aa^Fpa, Aa, Aa, Aa, Aa, Aa, Aa, Aa, Aa, Aa, Aa, Aa, Aa, Aa, Aa, Aa, Aa, Ha, Ha, Ms, Ms, Aa
Aa, Ms, Aa, Ha, Aa, Aa, Aa, Aa, Aa, Aa, Aa, Aa, Aa, Aa, Aa, Aa, Aa, Aa, Aa, Aa, Aa, Aa, Aa, Aa, Aa, Aa, Aa, Ha, Ha, Ha, Ha, Ha, Ms, Ha, Ha
Aa, Ms, Ms, Ha, Ha, Aa, Aa, Aa, Aa, Aa, Aa, Aa, Aa, Aa, Aa, Aa, Aa, Aa, Aa, Aa, Aa, Aa, Aa, Aa, Aa, Aa, Aa, Ha, Aa, Aa, Ha, Ha, Ms, Ms, Ha
Aa, Ms, Ms, Ha, Ha, Aa, Aa, Aa, Aa, Aa, Aa, Aa, Aa, Aa, Aa, Aa, Aa, Aa, Aa, Aa, Aa, Aa, Aa, Aa, Aa, Aa, Aa, Aa, Ms, Ha, Ha, Ha, Ms, Ms, Ha
Aa, Ms, Ms, Aa, Ha, Aa, Aa, Aa, Aa, Aa, Aa, Aa, Aa, Aa, Aa, Aa, Aa, Aa, Aa, Aa, Aa, Aa, Aa, Aa, Aa, Aa, Aa, Ms, Aa, Ha, Ha, Ha, Ms, Aa, Aa
Aa, Ms, Ms, Aa, Aa, Aa, Aa, Aa, Aa, Aa, Aa, Aa, Aa, Aa, Aa, Aa, Aa, Aa, Aa, Aa, Aa, Aa, Aa, Aa, Aa, Aa, Aa, Ms, Aa, Aa, Ha, Ha, Ms, Ms, Aa
Aa, Ms, Ms, Ha, Ha, Aa, Aa, Aa, Aa, Aa, Aa, Aa, Aa, Aa, Aa^Fpa, Aa, Aa, Aa, Aa, Aa, Aa, Aa^Fpa, Aa, Aa, Aa, Aa, Aa, Aa, Aa, Ha, Aa^Fpa, Ha, Ms, Ms, Ha
Aa, Ms, Aa, Aa, Aa, Aa, Aa, Aa, Aa, Aa, Aa, Aa, Aa, Aa, Aa, Aa, Aa, Aa, Aa, Aa, Aa, Aa, Aa, Aa, Aa, Aa, Aa, Ha, Aa, Ha, Ha, Ha, Ms, Ms, Ha
Aa, Ms, Aa, Ms, Ha, Aa, Aa, Aa, Aa, Aa, Aa, Aa, Aa^Fpa, Aa, Aa, Aa, Aa, Aa, Aa, Aa, Aa, Aa, Aa^Fpa, Aa, Aa, Aa, Ha, Ha, Aa, Ha, Ha, Ha, Ms, Ms, Aa
Aa, Ms, Ms, Aa, Aa, Aa, Aa, Aa, Aa, Aa, Aa^Fpa, Aa, Aa^Fpa, Aa, Aa, Aa, Aa, Aa, Aa, Aa, Aa, Aa^Fpa, Aa^Fpa, Aa^Fpa, Aa, Aa, Aa, Aa, Aa, Ha, Aa, Ms, Ms, Ms, Ms
Aa, Ms, Aa, Ms, Ha, Aa, Aa, Aa, Aa, Aa, Aa, Aa, Aa^Fpa, Aa, Aa, Aa, Aa, Aa, Aa, Aa, Aa, Aa^Fpa, Aa^Fpa, Aa^Fpa, Aa, Aa, Ha, Aa, Ha, Ha, Ha, Ha, Ms, Ms, Ms
Aa, Ms, Aa, Ms, Ha, Aa, Aa, Aa, Coa, Aa, Aa^Voa, Aa, Aa, Aa^Fpa, Aa, Aa, Aa^Fpa, Aa, Aa, Aa, Aa, Aa, Aa, Aa, Aa, Aa, Aa, Aa, Aa, Ha, Ha, Ms, Ms, Ms, Ms
Aa, Ms, Ms, Ms, Ha, Aa, Coa, Coa, Coa, Coa, Coa, Aa, Aa, Aa, Aa, Aa, Aa, Aa^Fpa, Aa^Fpa, Aa, Aa, Aa, Aa, Aa, Aa, Aa, Ha, Aa, Ha, Aa, Ha, Ha, Ms, Ms, Ms
Ms, Ms, Ms, Ms, Ha, Aa, Coa, Coa, Koa, Coa, Coa, Aa, Aa, Aa, Aa, Aa, Aa, Aa, Aa, Aa^Fpa, Aa, Aa, Aa, Aa, Aa, Aa, Aa^Fpa, Aa^Fpa, Aa, Ha, Ha, Ha, Ms, Ms, Ms
Ms, Ms, Ms, Ms, Ha, Aa, Coa, Coa, Coa, Coa, Coa, Aa, Aa, Aa, Aa, Aa, Aa, Aa, Aa^Fpa, Aa^Fpa, Aa^Fpa, Aa, Aa^Fpa, Aa, Aa^Fpa, Aa, Aa, Aa, Aa, Ha, Ha, Ha, Ms, Ms, Ms
Ms, Ms, Ms, Ms, Ha, Aa, Aa, Coa, Coa, Coa, Aa^Fpa, Aa, Aa^Fpa, Aa^Fpa, Aa, Aa, Aa^Fpa, Aa, Aa, Aa, Aa^Fpa, Aa^Fpa, Aa^Fpa, Aa, Aa, Aa, Aa, Aa, Aa, Ha, Ha, Ha, Ms, Ms, Ms
Ms, Ms, Ms, Ha, Ha, Aa, Aa, Aa, Aa, Aa, Aa, Aa, Aa, Aa, Aa, Aa, Aa, Aa, Aa, Aa, Aa, Aa, Aa, Aa^Fpa, Aa, Aa^Fpa, Aa, Aa, Aa, Ha, Ha, Ha, Ms, Ms, Ms
Ms, Ms, Ha, Ha, Ha, Aa, Aa, Aa, Aa, Aa, Aa, Aa, Aa, Aa, Aa, Aa, Aa, Aa, Aa, Aa, Aa, Aa, Aa, Aa, Aa, Aa, Aa, Aa, Aa, Ha, Ha, Ha, Ms, Ms, Ms
Ms, Ms, Ms, Ha, Ms, Aa, Aa, Aa, Aa, Aa, Aa, Aa, Aa, Aa, Aa, Aa, Aa, Aa, Aa, Aa, Aa, Aa, Aa, Aa, Aa, Aa, Aa, Aa, Aa, Aa, Aa, Aa, Ms, Ms, Ms
Ms, Ms, Ms, Aa^Fpa, Aa, Aa, Aa, Aa^Voa, Aa, Aa, Aa, Aa, Aa, Aa, Aa, Aa, Aa^Voa, Aa, Aa, Aa, Aa^Voa, Aa, Aa, Aa, Aa^Voa, Aa, Aa, Aa^Fpa, Aa^Fpa, Aa^Fpa, Aa^Fpa, Aa, Ms, Ms, Ms
Ms, Ms, Ms, Aa^Fpa, Aa, Aa, Aa, Aa, Aa, Aa, Aa, Aa, Aa, Aa^Voa, Aa, Aa, Aa, Aa^Voa, Aa, Aa, Aa, Aa^Voa, Aa, Aa, Aa, Aa, Aa, Aa^Voa, Aa^Ecf, Aa, Aa, Aa^Ecf, Ms, Ms^Br/, Ms^Br/
Ms, Ms, Aa^Voa, Aa^Voa, Aa, Aa^Voa, Aa^Voa, Aa^Voa, Aa, Aa, Aa^Voa, Aa^Voa, Aa^Voa, Aa, Aa, Aa, Aa, Aa^Ecf, Aa, Aa, Aa, Aa, Aa, Aa, Aa^Ecf, Aa, Aa, Aa^Voa, Aa, Aa^Voa, Aa^Voa, Aa^Voa, Ms, Ms, Ms^Br/
